1111111
1PEC111
1000111
1111111