1111111
1PEC1E1
1000111
1111111