1111111111111111
100000P00C001001
10C000C000C00011
10000C0000E00001
10000000C0000001
100000000000C001
1111111111111111