11111111
1PEC111
1000111
11111111111